44444444
40000004
400@0l04
40000004
40011004
40011004
40000004
40000004
40000004
40000004
44444444