55555555
50000005
500@0005
50000005
50022005
50022005
50000005
50000005
50000005
50000005
55555555